111111111111111111111111
11CCC000000000CCC01E0001
11110C000000111111110001
111100001C0000C000010001
10000P110CCC001111000001
111111111111111111111111