1111111111111111
100000CC0001C001
10C0011110010001
10C0000C00011101
1001000000CCC001
10010C0010001111
100100C010000001
1P00000C100000E1
1111111111111111