111111111111111111111
1000000000000P1000001
101011101111111010101
10101C001000000010101
101011111011111110101
1010000010001000101C1
111111101110101110111
100000000010100010001
101011111110101011101
101010000000101010001
101110111111111010101
100010000CCC000010101
101011101111111110101
101000101000000010101
111010101011111010111
10001C101010001010001
101111101010111011101
100000001010100010001
101111111010101110101
10001E0000100000001C1
111111111111111111111