1111111
1E000C1
1111011
10C00P1
1111111